COMPUTER	K AH M P Y UW T ER
FACULTY	F AE K AH L T IY
FORWARD	F AO R W ER D
HELLO	HH AH L OW
HELLO(2)	HH EH L OW
HEY	HH EY
HI	HH AY
IS	IH Z
LEFT	L EH F T
MOVE	M UW V
MY	M AY
NAME	N EY M
NICO	N IY K OW
NO	N OW
OK	OW K EY
RIGHT	R AY T
SCIENCE	S AY AH N S
STAFF	S T AE F
STUDENT	S T UW D AH N T
SURE	SH UH R
TURN	T ER N
YEAH	Y AE
YES	Y EH S
